---
title: Second Level
author: Lea Rosema
layout: game
tags:
  - tutorial
---
######################
#........#o....$$$$$$#
#.P.. o........$$$$$$#
#.... #..#........$$$#
#.... #..#...$.....$.#
#..$...............$.#
#.... #..#.....  ..$.#
#..$..#..#..... G..$$#
#.................$$$#
#..X.. o.#.......$$$$#
####o########..#######
#..o. $$$............#
#.ooo$$$ .....oo.....#
#$$$$$$$  #......o...#
######################
