---
title: Third Level
author: Lea Rosema
---
############
#P.o...o...#
#..o...o...#
#....X.....#
#.$$$o$$$.o#
#....o....o#
#....o....o#
#.$$$o$$$.o#
#....o....o#
############
