---
title: Fifth Level
author: Lea Rosema
---
#####################
#.............      #
#..$$$$$$$$.o.$o....#
#..........o...$oX..#
#o.$o.....o.o..o..o.#
#...o.....  ......o.#
#..o..o....o.o..o..o#
#.... o...o o...o...#
#o....$. ....o.$....#
#....o.o.o.o...o$...#
#o......$.. .....o..#
#...o.o ...o..o..o..#
#..o..#o. ...$..$$$.#
#....o#.o....o.$....#
#o....#.o.......$...#
#..###############..#
#o.......#...$....o.#
#P...o.o##.o....o...#
#.......#.......$$..#
#####################
